NO ./textures/simple_one/north.xpm
SO ./textures/simple_one/south.xpm
WE ./textures/simple_one/west.xpm
EA ./textures/simple_one/east.xpm
F ./textures/simple_one/floor.xpm
C ./textures/simple_one/ceiling.xpm

11111111111111
11111100111111
11111000011111
11110000001111
11100011000111
11000111100011
10N01111110001
10001111110001
11000111100011
11100011000111
11110000001111
11111000011111
11111100111111
11111111111111
