NO ./textures/north.xpm
SO ./textures/south.xpm
WE ./textures/west.xpm
EA ./textures/east.xpm
F ./textures/floor.xpm
C ./textures/ceiling.xpm

1111111111111111111111111111
1000000000110000000000010001
1011111100110111111100010101
10100W0100000100000100010101
1010110111110101110100010101
1010100000010100010100010101
1010111111010111010111010101
1000100001010000010000010001
1110101111011111011110110111
1000101000010000010000100001
1011111011110111011110101111
1000000010000100000010100001
1011111110111110111110101111
1000000000100000000010100001
1010111111010111111010111111
1010100001010000010010000001
1010101111010111011110110111
1010101000010100010000000101
1010101111110101111011110101
1010000000000100000000000101
1011111111110111111111110101
1000000000000000000000000001
1111111111111111111111111111
