NO ./textures/blue_one/north.xpm
SO ./textures/blue_one/south.xpm
WE ./textures/blue_one/west.xpm
EA ./textures/blue_one/east.xpm
F ./textures/blue_one/floor.xpm
C ./textures/blue_one/ceiling.xpm

111111
000101
101001
1100N1
111111
