NO ./textures/north.xpm
SO ./textures/south.xpm
WE ./textures/west.xpm
EA ./textures/east.xpm

F 45,45,60
C 110,110,140

111111111111111111111111111111111111
100000000000000000100000000000000001
101111111111111110101111111111111101
101000000000001000101000000000000101
101011111111101011101011111111110101
101010000001101000001010000000010101
101010111101101111101010111110010101
101010100001100000101010100010010101
101010101111111110101010101010010101
101000101000000010001000101010000101
101111101011111011111110101011111101
100000001010001010000010001000000001
111111101010101010111011111011111111
100000001000101000101000001000000001
101111111110101111101011101111111101
101000000000100000001010100000000101
101011111111111111101010111111110101
101000100000000000001010000000010101
101110101111111111111011111110010101
1000101000000000N001000000010000101
101110111111011111101111111011111101
101000000001010000001000001000000101
101011111101010111101011101111110101
101000001001000100001010001000010101
101111101111110101111011111010010101
100000100000000100000000000010000001
111111111111111111111111111111111111
