NO ./textures/simple_one/north.xpm
SO ./textures/simple_one/south.xpm
WE ./textures/simple_one/west.xpm
EA ./textures/simple_one/east.xpm
F ./textures/simple_one/floor.xpm
C ./textures/simple_one/ceiling.xpm

11111111111111
11111100101111
11111000010111
11110000001011
11100011000111
11000111100011
10001101110001
10001111110001        111
11000111100011        1N0 
11100011000111        000
11110000001111           
11111000011111
11111100111111
11111111111111



