NO ./textures/blue_one/north.xpm
SO ./textures/blue_one/south.xpm
WE ./textures/blue_one/west.xpm
EA ./textures/blue_one/east.xpm

F 211,211,211
C 135,206,,235

111111
100101
101001
1100N1
111111
